7666666666677777
7              6
7      66666   7
6     7        7
7     7  6667777
7     8        7
7   67777      7
7   7   66677  7
7   7   7      7
7   7   6  77777
7       6      7
9       6      7
7       7   x  7
9 7777777      7
7              7
9669999999967777
