0022222222220000
0              1
0      11111   0
1     0        0
0     0  1110000
0     3        0
0   10000      0
0   0   11100  0
0   0   0      0
0   0   1  00000
0       1      0
2       1      0
0       0   x  0
2 3000000      0
0              0
2112222222210000
